010111011110-
010101010010-
010101010010-
010101010010-
010101010010-
011101110010-
000000000000-
000000000000